220152308402;220152707824;399422;2;1;11;1;3;1
220152707824;220153139869;432045;-1;0;-1;0;-1;0
220153139869;220165067403;11927534;7;1;11;1;3;1
220165067403;223076378280;2911310877;-1;0;-1;0;-1;0
223076378280;223076379378;1098;4;1;11;1;3;1
223076379378;223076382203;2825;-1;0;-1;0;-1;0
223076382203;223076385509;3306;1;1;11;1;3;1
223076385509;223076641119;255610;-1;0;-1;0;-1;0
223076641119;223100614723;23973604;8;1;11;1;3;1
223100614723;226930023403;3829408680;-1;0;-1;0;-1;0
226930023403;226930024634;1231;4;1;11;1;3;1
226930024634;226930029764;5130;-1;0;-1;0;-1;0
226930029764;226930033217;3453;1;1;11;1;3;1
226930033217;226930297896;264679;-1;0;-1;0;-1;0
226930297896;226955643345;25345449;8;1;11;1;3;1
226955643345;230406953277;3451309932;-1;0;-1;0;-1;0
230406953277;230406954409;1132;4;1;11;1;3;1
230406954409;230406957335;2926;-1;0;-1;0;-1;0
230406957335;230406960613;3278;1;1;11;1;3;1
230406960613;230407194940;234327;-1;0;-1;0;-1;0
230407194940;230441129801;33934861;8;1;11;1;3;1
230441129801;233873854347;3432724546;-1;0;-1;0;-1;0
233873854347;233873855559;1212;4;1;11;1;3;1
233873855559;233873858752;3193;-1;0;-1;0;-1;0
233873858752;233873862104;3352;1;1;11;1;3;1
233873862104;233874150132;288028;-1;0;-1;0;-1;0
233874150132;233900138538;25988406;8;1;11;1;3;1
233900138538;237728213169;3828074631;-1;0;-1;0;-1;0
237728213169;237728214316;1147;4;1;11;1;3;1
237728214316;237728219166;4850;-1;0;-1;0;-1;0
237728219166;237728222525;3359;1;1;11;1;3;1
237728222525;237728493697;271172;-1;0;-1;0;-1;0
237728493697;237753311887;24818190;8;1;11;1;3;1
237753311887;241761626811;4008314924;-1;0;-1;0;-1;0
241761626811;241761627870;1059;4;1;11;1;3;1
241761627870;241761630179;2309;-1;0;-1;0;-1;0
241761630179;241761633456;3277;1;1;11;1;3;1
241761633456;241761863312;229856;-1;0;-1;0;-1;0
241761863312;241786758255;24894943;8;1;11;1;3;1
241786758255;245945404652;4158646397;-1;0;-1;0;-1;0
245945404652;245945405896;1244;4;1;11;1;3;1
245945405896;245945410519;4623;-1;0;-1;0;-1;0
245945410519;245945413974;3455;1;1;11;1;3;1
245945413974;245945708056;294082;-1;0;-1;0;-1;0
245945708056;245971919059;26211003;8;1;11;1;3;1
245971919059;249710951784;3739032725;-1;0;-1;0;-1;0
249710951784;249710952895;1111;4;1;11;1;3;1
249710952895;249710955171;2276;-1;0;-1;0;-1;0
249710955171;249710958486;3315;1;1;11;1;3;1
249710958486;249711197405;238919;-1;0;-1;0;-1;0
249711197405;249738547825;27350420;8;1;11;1;3;1
249738547825;250566127127;827579302;-1;0;-1;0;-1;0
250566127127;250580042232;13915105;2;1;9;1;3;1
250580042232;250580132903;90671;1,2;2;9;1;3;1
250580132903;250580133283;380;1,2;2;9;1;3;1
250580133283;250580133424;141;1,2;2;9;1;3;1
250580133424;250580133517;93;1,2;2;9;1;3;1
250580133517;250580133543;26;1,2;2;9;1;3;1
250580133543;250580133550;7;1,2;2;9;1;3;1
250580133550;250580133580;30;1,2;2;9;1;3;1
250580133580;250580133683;103;1,2;2;9;1;3;1
250580133683;250580133705;22;1,2;2;9;1;3;1
250580133705;250580133783;78;1,2;2;9;1;3;1
250580133783;250580133806;23;1,2;2;9;1;3;1
250580133806;250580133855;49;1,2;2;9;1;3;1
250580133855;250580134682;827;1,2;2;9;1;3;1
250580134682;250580134849;167;1,2;2;9;1;3;1
250580134849;250580134894;45;1,2;2;9;1;3;1
250580134894;250580135114;220;1,2;2;9;1;3;1
250580135114;250580135135;21;1,2;2;9;1;3;1
250580135135;250580135505;370;1,2;2;9;1;3;1
250580135505;250580135552;47;1,2;2;9;1;3;1
250580135552;250580135590;38;1,2;2;9;1;3;1
250580135590;250580135595;5;1,2;2;9;1;3;1
250580135595;250580135610;15;1,2;2;9;1;3;1
250580135610;250580135666;56;1,2;2;9;1;3;1
250580135666;250580135814;148;1,2;2;9;1;3;1
250580135814;250580135877;63;1,2;2;9;1;3;1
250580135877;250580136431;554;1,2;2;9;1;3;1
250580136431;250580136457;26;1,2;2;9;1;3;1
250580136457;250580136526;69;1,2;2;9;1;3;1
250580136526;250580136753;227;1,2;2;9;1;3;1
250580136753;250580136792;39;1,2;2;9;1;3;1
250580136792;250580136819;27;1,2;2;9;1;3;1
250580136819;250580136841;22;1,2;2;9;1;3;1
250580136841;250580136904;63;1,2;2;9;1;3;1
250580136904;250580137045;141;1,2;2;9;1;3;1
250580137045;250580137093;48;1,2;2;9;1;3;1
250580137093;250580137132;39;1,2;2;9;1;3;1
250580137132;250580137177;45;1,2;2;9;1;3;1
250580137177;250580137189;12;1,2;2;9;1;3;1
250580137189;250580137244;55;1,2;2;9;1;3;1
250580137244;250580137283;39;1,2;2;9;1;3;1
250580137283;250580137299;16;1,2;2;9;1;3;1
250580137299;250580137330;31;1,2;2;9;1;3;1
250580137330;250580137368;38;1,2;2;9;1;3;1
250580137368;250580137389;21;1,2;2;9;1;3;1
250580137389;250580137521;132;1,2;2;9;1;3;1
250580137521;250580137581;60;1,2;2;9;1;3;1
250580137581;250580137602;21;1,2;2;9;1;3;1
250580137602;250580137604;2;1,2;2;9;1;3;1
250580137604;250580137639;35;1,2;2;9;1;3;1
250580137639;250580137648;9;1,2;2;9;1;3;1
250580137648;250580137683;35;1,2;2;9;1;3;1
250580137683;250580137688;5;1,2;2;9;1;3;1
250580137688;250580137725;37;1,2;2;9;1;3;1
250580137725;250580137748;23;1,2;2;9;1;3;1
250580137748;250580137970;222;1,2;2;9;1;3;1
250580137970;250580138017;47;1,2;2;9;1;3;1
250580138017;250580138025;8;1,2;2;9;1;3;1
250580138025;250580138043;18;1,2;2;9;1;3;1
250580138043;250580138044;1;1,2;2;9;1;3;1
250580138044;250580138078;34;1,2;2;9;1;3;1
250580138078;250580138110;32;1,2;2;9;1;3;1
250580138110;250580138196;86;1,2;2;9;1;3;1
250580138196;250580138251;55;1,2;2;9;1;3;1
250580138251;250580138275;24;1,2;2;9;1;3;1
250580138275;250580138280;5;1,2;2;9;1;3;1
250580138280;250580138317;37;1,2;2;9;1;3;1
250580138317;250580138342;25;1,2;2;9;1;3;1
250580138342;250580138354;12;1,2;2;9;1;3;1
250580138354;250580138404;50;1,2;2;9;1;3;1
250580138404;250580138418;14;1,2;2;9;1;3;1
250580138418;250580138487;69;1,2;2;9;1;3;1
250580138487;250580138519;32;1,2;2;9;1;3;1
250580138519;250580138559;40;1,2;2;9;1;3;1
250580138559;250580138572;13;1,2;2;9;1;3;1
250580138572;250580138581;9;1,2;2;9;1;3;1
250580138581;250580138605;24;1,2;2;9;1;3;1
250580138605;250580138618;13;1,2;2;9;1;3;1
250580138618;250580138626;8;1,2;2;9;1;3;1
250580138626;250580138636;10;1,2;2;9;1;3;1
250580138636;250580138657;21;1,2;2;9;1;3;1
250580138657;250580138679;22;1,2;2;9;1;3;1
250580138679;250580138713;34;1,2;2;9;1;3;1
250580138713;250580138743;30;1,2;2;9;1;3;1
250580138743;250580138763;20;1,2;2;9;1;3;1
250580138763;250580138791;28;1,2;2;9;1;3;1
250580138791;250580138819;28;1,2;2;9;1;3;1
250580138819;250580138840;21;1,2;2;9;1;3;1
250580138840;250580138843;3;1,2;2;9;1;3;1
250580138843;250580138864;21;1,2;2;9;1;3;1
250580138864;250580138882;18;1,2;2;9;1;3;1
250580138882;250580138909;27;1,2;2;9;1;3;1
250580138909;250580138913;4;1,2;2;9;1;3;1
250580138913;250580138935;22;1,2;2;9;1;3;1
250580138935;250580138954;19;1,2;2;9;1;3;1
250580138954;250580138991;37;1,2;2;9;1;3;1
250580138991;250580139168;177;1,2;2;9;1;3;1
250580139168;250580139319;151;1,2;2;9;1;3;1
250580139319;250580139341;22;1,2;2;9;1;3;1
250580139341;250580139359;18;1,2;2;9;1;3;1
250580139359;250580139708;349;1,2;2;9;1;3;1
250580139708;250580139910;202;1,2;2;9;1;3;1
250580139910;250580139943;33;1,2;2;9;1;3;1
250580139943;250580140031;88;1,2;2;9;1;3;1
250580140031;250580140061;30;1,2;2;9;1;3;1
250580140061;250580140128;67;1,2;2;9;1;3;1
250580140128;250580140310;182;1,2;2;9;1;3;1
250580140310;250580140394;84;1,2;2;9;1;3;1
250580140394;250580140419;25;1,2;2;9;1;3;1
250580140419;250580140471;52;1,2;2;9;1;3;1
250580140471;250580140498;27;1,2;2;9;1;3;1
250580140498;250580140572;74;1,2;2;9;1;3;1
250580140572;250580140599;27;1,2;2;9;1;3;1
250580140599;250580140681;82;1,2;2;9;1;3;1
250580140681;250580140798;117;1,2;2;9;1;3;1
250580140798;250580140860;62;1,2;2;9;1;3;1
250580140860;250580140889;29;1,2;2;9;1;3;1
250580140889;250580140916;27;1,2;2;9;1;3;1
250580140916;250580140976;60;1,2;2;9;1;3;1
250580140976;250580141000;24;1,2;2;9;1;3;1
250580141000;250580141013;13;1,2;2;9;1;3;1
250580141013;250580141035;22;1,2;2;9;1;3;1
250580141035;250580141049;14;1,2;2;9;1;3;1
250580141049;250580141071;22;1,2;2;9;1;3;1
250580141071;250580141110;39;1,2;2;9;1;3;1
250580141110;250580141112;2;1,2;2;9;1;3;1
250580141112;250580141132;20;1,2;2;9;1;3;1
250580141132;250580141154;22;1,2;2;9;1;3;1
250580141154;250580141177;23;1,2;2;9;1;3;1
250580141177;250580141179;2;1,2;2;9;1;3;1
250580141179;250580141211;32;1,2;2;9;1;3;1
250580141211;250580141265;54;1,2;2;9;1;3;1
250580141265;250580141341;76;1,2;2;9;1;3;1
250580141341;250580141522;181;1,2;2;9;1;3;1
250580141522;250580141761;239;1,2;2;9;1;3;1
250580141761;250580141773;12;1,2;2;9;1;3;1
250580141773;250580141815;42;1,2;2;9;1;3;1
250580141815;250580141890;75;1,2;2;9;1;3;1
250580141890;250580141914;24;1,2;2;9;1;3;1
250580141914;250580142214;300;1,2;2;9;1;3;1
250580142214;250580142391;177;1,2;2;9;1;3;1
250580142391;250580142414;23;1,2;2;9;1;3;1
250580142414;250580142598;184;1,2;2;9;1;3;1
250580142598;250580142631;33;1,2;2;9;1;3;1
250580142631;250580142652;21;1,2;2;9;1;3;1
250580142652;250580142682;30;1,2;2;9;1;3;1
250580142682;250580142702;20;1,2;2;9;1;3;1
250580142702;250580142734;32;1,2;2;9;1;3;1
250580142734;250580142755;21;1,2;2;9;1;3;1
250580142755;250580142794;39;1,2;2;9;1;3;1
250580142794;250580142812;18;1,2;2;9;1;3;1
250580142812;250580142815;3;1,2;2;9;1;3;1
250580142815;250580142837;22;1,2;2;9;1;3;1
250580142837;250580142846;9;1,2;2;9;1;3;1
250580142846;250580142870;24;1,2;2;9;1;3;1
250580142870;250580142899;29;1,2;2;9;1;3;1
250580142899;250580142921;22;1,2;2;9;1;3;1
250580142921;250580142965;44;1,2;2;9;1;3;1
250580142965;250580142980;15;1,2;2;9;1;3;1
250580142980;250580143003;23;1,2;2;9;1;3;1
250580143003;250580143019;16;1,2;2;9;1;3;1
250580143019;250580143033;14;1,2;2;9;1;3;1
250580143033;250580143068;35;1,2;2;9;1;3;1
250580143068;250580143069;1;1,2;2;9;1;3;1
250580143069;250580143115;46;1,2;2;9;1;3;1
250580143115;250580143124;9;1,2;2;9;1;3;1
250580143124;250580143148;24;1,2;2;9;1;3;1
250580143148;250580143173;25;1,2;2;9;1;3;1
250580143173;250580143183;10;1,2;2;9;1;3;1
250580143183;250580143186;3;1,2;2;9;1;3;1
250580143186;250580143205;19;1,2;2;9;1;3;1
250580143205;250580143207;2;1,2;2;9;1;3;1
250580143207;250580143212;5;1,2;2;9;1;3;1
250580143212;250580143235;23;1,2;2;9;1;3;1
250580143235;250580143238;3;1,2;2;9;1;3;1
250580143238;250580143259;21;1,2;2;9;1;3;1
250580143259;250580143264;5;1,2;2;9;1;3;1
250580143264;250580143274;10;1,2;2;9;1;3;1
250580143274;250580143296;22;1,2;2;9;1;3;1
250580143296;250580143318;22;1,2;2;9;1;3;1
250580143318;250580143364;46;1,2;2;9;1;3;1
250580143364;250580143384;20;1,2;2;9;1;3;1
250580143384;250580143468;84;1,2;2;9;1;3;1
250580143468;250580143485;17;1,2;2;9;1;3;1
250580143485;250580143505;20;1,2;2;9;1;3;1
250580143505;250580143521;16;1,2;2;9;1;3;1
250580143521;250580143539;18;1,2;2;9;1;3;1
250580143539;250580143572;33;1,2;2;9;1;3;1
250580143572;250580143577;5;1,2;2;9;1;3;1
250580143577;250580143604;27;1,2;2;9;1;3;1
250580143604;250580143627;23;1,2;2;9;1;3;1
250580143627;250580143660;33;1,2;2;9;1;3;1
250580143660;250580143697;37;1,2;2;9;1;3;1
250580143697;250580143728;31;1,2;2;9;1;3;1
250580143728;250580143729;1;1,2;2;9;1;3;1
250580143729;250580143763;34;1,2;2;9;1;3;1
250580143763;250580143789;26;1,2;2;9;1;3;1
250580143789;250580143791;2;1,2;2;9;1;3;1
250580143791;250580143803;12;1,2;2;9;1;3;1
250580143803;250580143817;14;1,2;2;9;1;3;1
250580143817;250580143831;14;1,2;2;9;1;3;1
250580143831;250580143896;65;1,2;2;9;1;3;1
250580143896;250580143904;8;1,2;2;9;1;3;1
250580143904;250580143923;19;1,2;2;9;1;3;1
250580143923;250580143937;14;1,2;2;9;1;3;1
250580143937;250580143941;4;1,2;2;9;1;3;1
250580143941;250580143959;18;1,2;2;9;1;3;1
250580143959;250580143962;3;1,2;2;9;1;3;1
250580143962;250580143964;2;1,2;2;9;1;3;1
250580143964;250580143966;2;1,2;2;9;1;3;1
250580143966;250580143989;23;1,2;2;9;1;3;1
250580143989;250580144000;11;1,2;2;9;1;3;1
250580144000;250580144012;12;1,2;2;9;1;3;1
250580144012;250580144018;6;1,2;2;9;1;3;1
250580144018;250580144022;4;1,2;2;9;1;3;1
250580144022;250580144026;4;1,2;2;9;1;3;1
250580144026;250580144034;8;1,2;2;9;1;3;1
250580144034;250580144054;20;1,2;2;9;1;3;1
250580144054;250580144059;5;1,2;2;9;1;3;1
250580144059;250580144069;10;1,2;2;9;1;3;1
250580144069;250580144072;3;1,2;2;9;1;3;1
250580144072;250580144088;16;1,2;2;9;1;3;1
250580144088;250580144111;23;1,2;2;9;1;3;1
250580144111;250580144119;8;1,2;2;9;1;3;1
250580144119;250580144121;2;1,2;2;9;1;3;1
250580144121;250580144159;38;1,2;2;9;1;3;1
250580144159;250580144184;25;1,2;2;9;1;3;1
250580144184;250580144195;11;1,2;2;9;1;3;1
250580144195;250580144226;31;1,2;2;9;1;3;1
250580144226;250580144249;23;1,2;2;9;1;3;1
250580144249;250580144269;20;1,2;2;9;1;3;1
250580144269;250580144278;9;1,2;2;9;1;3;1
250580144278;250580144317;39;1,2;2;9;1;3;1
250580144317;250580144509;192;1,2;2;9;1;3;1
250580144509;250580144556;47;1,2;2;9;1;3;1
250580144556;250580144795;239;1,2;2;9;1;3;1
250580144795;250580144803;8;1,2;2;9;1;3;1
250580144803;250580144825;22;1,2;2;9;1;3;1
250580144825;250580144866;41;1,2;2;9;1;3;1
250580144866;250580144900;34;1,2;2;9;1;3;1
250580144900;250580144908;8;1,2;2;9;1;3;1
250580144908;250580144927;19;1,2;2;9;1;3;1
250580144927;250580144931;4;1,2;2;9;1;3;1
250580144931;250580145037;106;1,2;2;9;1;3;1
250580145037;250580145183;146;1,2;2;9;1;3;1
250580145183;250580145220;37;1,2;2;9;1;3;1
250580145220;250580145235;15;1,2;2;9;1;3;1
250580145235;250580145291;56;1,2;2;9;1;3;1
250580145291;250580145394;103;1,2;2;9;1;3;1
250580145394;250580145472;78;1,2;2;9;1;3;1
250580145472;250580145499;27;1,2;2;9;1;3;1
250580145499;250580145539;40;1,2;2;9;1;3;1
250580145539;250580145545;6;1,2;2;9;1;3;1
250580145545;250580145601;56;1,2;2;9;1;3;1
250580145601;250580145675;74;1,2;2;9;1;3;1
250580145675;250580145717;42;1,2;2;9;1;3;1
250580145717;250580145773;56;1,2;2;9;1;3;1
250580145773;250580145796;23;1,2;2;9;1;3;1
250580145796;250580145845;49;1,2;2;9;1;3;1
250580145845;250580145849;4;1,2;2;9;1;3;1
250580145849;250580145887;38;1,2;2;9;1;3;1
250580145887;250580145900;13;1,2;2;9;1;3;1
250580145900;250580145955;55;1,2;2;9;1;3;1
250580145955;250580145976;21;1,2;2;9;1;3;1
250580145976;250580145994;18;1,2;2;9;1;3;1
250580145994;250580146006;12;1,2;2;9;1;3;1
250580146006;250580146009;3;1,2;2;9;1;3;1
250580146009;250580146035;26;1,2;2;9;1;3;1
250580146035;250580146044;9;1,2;2;9;1;3;1
250580146044;250580146065;21;1,2;2;9;1;3;1
250580146065;250580146085;20;1,2;2;9;1;3;1
250580146085;250580146089;4;1,2;2;9;1;3;1
250580146089;250580146103;14;1,2;2;9;1;3;1
250580146103;250580146178;75;1,2;2;9;1;3;1
250580146178;250580146297;119;1,2;2;9;1;3;1
250580146297;250580146307;10;1,2;2;9;1;3;1
250580146307;250580146343;36;1,2;2;9;1;3;1
250580146343;250580146372;29;1,2;2;9;1;3;1
250580146372;250580146391;19;1,2;2;9;1;3;1
250580146391;250580146410;19;1,2;2;9;1;3;1
250580146410;250580146444;34;1,2;2;9;1;3;1
250580146444;250580146473;29;1,2;2;9;1;3;1
250580146473;250580146475;2;1,2;2;9;1;3;1
250580146475;250580146520;45;1,2;2;9;1;3;1
250580146520;250580146546;26;1,2;2;9;1;3;1
250580146546;250580146561;15;1,2;2;9;1;3;1
250580146561;250580146592;31;1,2;2;9;1;3;1
250580146592;250580146596;4;1,2;2;9;1;3;1
250580146596;250580146615;19;1,2;2;9;1;3;1
250580146615;250580146634;19;1,2;2;9;1;3;1
250580146634;250580146635;1;1,2;2;9;1;3;1
250580146635;250580146643;8;1,2;2;9;1;3;1
250580146643;250580146655;12;1,2;2;9;1;3;1
250580146655;250580146682;27;1,2;2;9;1;3;1
250580146682;250580146701;19;1,2;2;9;1;3;1
250580146701;250580146753;52;1,2;2;9;1;3;1
250580146753;250580146756;3;1,2;2;9;1;3;1
250580146756;250580146795;39;1,2;2;9;1;3;1
250580146795;250580146810;15;1,2;2;9;1;3;1
250580146810;250580146826;16;1,2;2;9;1;3;1
250580146826;250580146836;10;1,2;2;9;1;3;1
250580146836;250580146885;49;1,2;2;9;1;3;1
250580146885;250580146903;18;1,2;2;9;1;3;1
250580146903;250580146948;45;1,2;2;9;1;3;1
250580146948;250580146955;7;1,2;2;9;1;3;1
250580146955;250580146957;2;1,2;2;9;1;3;1
250580146957;250580146969;12;1,2;2;9;1;3;1
250580146969;250580146990;21;1,2;2;9;1;3;1
250580146990;250580146991;1;1,2;2;9;1;3;1
250580146991;250580147014;23;1,2;2;9;1;3;1
250580147014;250580147018;4;1,2;2;9;1;3;1
250580147018;250580147037;19;1,2;2;9;1;3;1
250580147037;250580147087;50;1,2;2;9;1;3;1
250580147087;250580147108;21;1,2;2;9;1;3;1
250580147108;250580147147;39;1,2;2;9;1;3;1
250580147147;250580147149;2;1,2;2;9;1;3;1
250580147149;250580147179;30;1,2;2;9;1;3;1
250580147179;250580147184;5;1,2;2;9;1;3;1
250580147184;250580147202;18;1,2;2;9;1;3;1
250580147202;250580147209;7;1,2;2;9;1;3;1
250580147209;250580147216;7;1,2;2;9;1;3;1
250580147216;250580147240;24;1,2;2;9;1;3;1
250580147240;250580147254;14;1,2;2;9;1;3;1
250580147254;250580147261;7;1,2;2;9;1;3;1
250580147261;250580147269;8;1,2;2;9;1;3;1
250580147269;250580147289;20;1,2;2;9;1;3;1
250580147289;250580147323;34;1,2;2;9;1;3;1
250580147323;250580147344;21;1,2;2;9;1;3;1
250580147344;250580147357;13;1,2;2;9;1;3;1
250580147357;250580147376;19;1,2;2;9;1;3;1
250580147376;250580147396;20;1,2;2;9;1;3;1
250580147396;250580147410;14;1,2;2;9;1;3;1
250580147410;250580147430;20;1,2;2;9;1;3;1
250580147430;250580147458;28;1,2;2;9;1;3;1
250580147458;250580147469;11;1,2;2;9;1;3;1
250580147469;250580147485;16;1,2;2;9;1;3;1
250580147485;250580147504;19;1,2;2;9;1;3;1
250580147504;250580147523;19;1,2;2;9;1;3;1
250580147523;250580147528;5;1,2;2;9;1;3;1
250580147528;250580147544;16;1,2;2;9;1;3;1
250580147544;250580147555;11;1,2;2;9;1;3;1
250580147555;250580147586;31;1,2;2;9;1;3;1
250580147586;250580147628;42;1,2;2;9;1;3;1
250580147628;250580147663;35;1,2;2;9;1;3;1
250580147663;250580147695;32;1,2;2;9;1;3;1
250580147695;250580147704;9;1,2;2;9;1;3;1
250580147704;250580147709;5;1,2;2;9;1;3;1
250580147709;250580147732;23;1,2;2;9;1;3;1
250580147732;250580147779;47;1,2;2;9;1;3;1
250580147779;250580147801;22;1,2;2;9;1;3;1
250580147801;250580147838;37;1,2;2;9;1;3;1
250580147838;250580147916;78;1,2;2;9;1;3;1
250580147916;250580147966;50;1,2;2;9;1;3;1
250580147966;250580147996;30;1,2;2;9;1;3;1
250580147996;250580148016;20;1,2;2;9;1;3;1
250580148016;250580148386;370;1,2;2;9;1;3;1
250580148386;250580148518;132;1,2;2;9;1;3;1
250580148518;250580148556;38;1,2;2;9;1;3;1
250580148556;250580148648;92;1,2;2;9;1;3;1
250580148648;250580148661;13;1,2;2;9;1;3;1
250580148661;250580148706;45;1,2;2;9;1;3;1
250580148706;250580148754;48;1,2;2;9;1;3;1
250580148754;250580148763;9;1,2;2;9;1;3;1
250580148763;250580148778;15;1,2;2;9;1;3;1
250580148778;250580148791;13;1,2;2;9;1;3;1
250580148791;250580148819;28;1,2;2;9;1;3;1
250580148819;250580148826;7;1,2;2;9;1;3;1
250580148826;250580148847;21;1,2;2;9;1;3;1
250580148847;250580148867;20;1,2;2;9;1;3;1
250580148867;250580148875;8;1,2;2;9;1;3;1
250580148875;250580148877;2;1,2;2;9;1;3;1
250580148877;250580148900;23;1,2;2;9;1;3;1
250580148900;250580148902;2;1,2;2;9;1;3;1
250580148902;250580148929;27;1,2;2;9;1;3;1
250580148929;250580148951;22;1,2;2;9;1;3;1
250580148951;250580148981;30;1,2;2;9;1;3;1
250580148981;250580149017;36;1,2;2;9;1;3;1
250580149017;250580149026;9;1,2;2;9;1;3;1
250580149026;250580149049;23;1,2;2;9;1;3;1
250580149049;250580149059;10;1,2;2;9;1;3;1
250580149059;250580149074;15;1,2;2;9;1;3;1
250580149074;250580149078;4;1,2;2;9;1;3;1
250580149078;250580149105;27;1,2;2;9;1;3;1
250580149105;250580149106;1;1,2;2;9;1;3;1
250580149106;250580149107;1;1,2;2;9;1;3;1
250580149107;250580149139;32;1,2;2;9;1;3;1
250580149139;250580149219;80;1,2;2;9;1;3;1
250580149219;250580149241;22;1,2;2;9;1;3;1
250580149241;250580149296;55;1,2;2;9;1;3;1
250580149296;250580149410;114;1,2;2;9;1;3;1
250580149410;250580149437;27;1,2;2;9;1;3;1
250580149437;250580149456;19;1,2;2;9;1;3;1
250580149456;250580149480;24;1,2;2;9;1;3;1
250580149480;250580149511;31;1,2;2;9;1;3;1
250580149511;250580149533;22;1,2;2;9;1;3;1
250580149533;250580149639;106;1,2;2;9;1;3;1
250580149639;250580149722;83;1,2;2;9;1;3;1
250580149722;250580149752;30;1,2;2;9;1;3;1
250580149752;250580149783;31;1,2;2;9;1;3;1
250580149783;250580149873;90;1,2;2;9;1;3;1
250580149873;250580149903;30;1,2;2;9;1;3;1
250580149903;250580149944;41;1,2;2;9;1;3;1
250580149944;250580149978;34;1,2;2;9;1;3;1
250580149978;250580150021;43;1,2;2;9;1;3;1
250580150021;250580150051;30;1,2;2;9;1;3;1
250580150051;250580150077;26;1,2;2;9;1;3;1
250580150077;250580150106;29;1,2;2;9;1;3;1
250580150106;250580150136;30;1,2;2;9;1;3;1
250580150136;250580150171;35;1,2;2;9;1;3;1
250580150171;250580150199;28;1,2;2;9;1;3;1
250580150199;250580150226;27;1,2;2;9;1;3;1
250580150226;250580150255;29;1,2;2;9;1;3;1
250580150255;250580150284;29;1,2;2;9;1;3;1
250580150284;250580150313;29;1,2;2;9;1;3;1
250580150313;250580150350;37;1,2;2;9;1;3;1
250580150350;250580150382;32;1,2;2;9;1;3;1
250580150382;250580150449;67;1,2;2;9;1;3;1
250580150449;250580150583;134;1,2;2;9;1;3;1
250580150583;250580150625;42;1,2;2;9;1;3;1
250580150625;250580150662;37;1,2;2;9;1;3;1
250580150662;250580150722;60;1,2;2;9;1;3;1
250580150722;250580150773;51;1,2;2;9;1;3;1
250580150773;250580150820;47;1,2;2;9;1;3;1
250580150820;250580150890;70;1,2;2;9;1;3;1
250580150890;250580150911;21;1,2;2;9;1;3;1
250580150911;250580150949;38;1,2;2;9;1;3;1
250580150949;250580151565;616;1,2;2;9;1;3;1
250580151565;250580151604;39;1,2;2;9;1;3;1
250580151604;250580151614;10;1,2;2;9;1;3;1
250580151614;250580151673;59;1,2;2;9;1;3;1
250580151673;250580151679;6;1,2;2;9;1;3;1
250580151679;250580151712;33;1,2;2;9;1;3;1
250580151712;250580151724;12;1,2;2;9;1;3;1
250580151724;250580151777;53;1,2;2;9;1;3;1
250580151777;250580151837;60;1,2;2;9;1;3;1
250580151837;250580151847;10;1,2;2;9;1;3;1
250580151847;250580151951;104;1,2;2;9;1;3;1
250580151951;250580151977;26;1,2;2;9;1;3;1
250580151977;250580152205;228;1,2;2;9;1;3;1
250580152205;250580152240;35;1,2;2;9;1;3;1
250580152240;250580152258;18;1,2;2;9;1;3;1
250580152258;250580152297;39;1,2;2;9;1;3;1
250580152297;250580152353;56;1,2;2;9;1;3;1
250580152353;250580152360;7;1,2;2;9;1;3;1
250580152360;250580152400;40;1,2;2;9;1;3;1
250580152400;250580152416;16;1,2;2;9;1;3;1
250580152416;250580152436;20;1,2;2;9;1;3;1
250580152436;250580152468;32;1,2;2;9;1;3;1
250580152468;250580152593;125;1,2;2;9;1;3;1
250580152593;250580152666;73;1,2;2;9;1;3;1
250580152666;250580152706;40;1,2;2;9;1;3;1
250580152706;250580152813;107;1,2;2;9;1;3;1
250580152813;250580152848;35;1,2;2;9;1;3;1
250580152848;250580152934;86;1,2;2;9;1;3;1
250580152934;250580152974;40;1,2;2;9;1;3;1
250580152974;250580153068;94;1,2;2;9;1;3;1
250580153068;250580153536;468;1,2;2;9;1;3;1
250580153536;250580153573;37;1,2;2;9;1;3;1
250580153573;250580153614;41;1,2;2;9;1;3;1
250580153614;250580153660;46;1,2;2;9;1;3;1
250580153660;250580153696;36;1,2;2;9;1;3;1
250580153696;250580153737;41;1,2;2;9;1;3;1
250580153737;250580153770;33;1,2;2;9;1;3;1
250580153770;250580153804;34;1,2;2;9;1;3;1
250580153804;250580153846;42;1,2;2;9;1;3;1
250580153846;250580154390;544;1,2;2;9;1;3;1
250580154390;250580155149;759;1,2;2;9;1;3;1
250580155149;250580155398;249;1,2;2;9;1;3;1
250580155398;250580155446;48;1,2;2;9;1;3;1
250580155446;250580155503;57;1,2;2;9;1;3;1
250580155503;250580155538;35;1,2;2;9;1;3;1
250580155538;250580155940;402;1,2;2;9;1;3;1
250580155940;250580156441;501;1,2;2;9;1;3;1
250580156441;250580156506;65;1,2;2;9;1;3;1
250580156506;250580166198;9692;1,2;2;9;1;3;1
250580166198;250580177208;11010;1,2;2;9;1;3;1
250580177208;250580177532;324;1,2;2;9;1;3;1
250580177532;250580201261;23729;1,2;2;9;1;3;1
250580201261;250580201786;525;1,2,4;3;9;1;3;1
250580201786;250580203997;2211;1,2;2;9;1;3;1
250580203997;250580204222;225;0,1,2;3;9;1;3;1
250580204222;250580303246;99024;1,2;2;9;1;3;1
250580303246;250580368594;65348;1,2;2;9;1;3;1
250580368594;250580624231;255637;1,2;2;9;1;3;1
250580624231;250580667431;43200;1,2;2;9;1;3;1
250580667431;250581006383;338952;1,2;2;9;1;3;1
250581006383;250581063093;56710;1,2;2;9;1;3;1
250581063093;250581148423;85330;1,2;2;9;1;3;1
250581148423;250581152290;3867;1,2,4;3;9;1;3;1
250581152290;250581215164;62874;1,2;2;9;1;3;1
250581215164;250582226488;1011324;1,2;2;9;1;3;1
250582226488;250582233645;7157;1,2;2;9;1;3;1
250582233645;250582265989;32344;1,2;2;9;1;3;1
250582265989;250582298613;32624;1,2;2;9;1;3;1
250582298613;250582302982;4369;0,1,2;3;9;1;3;1
250582302982;250582318174;15192;0,1,2;3;9;1;3;1
250582318174;250582323584;5410;0,1,2;3;9;1;3;1
250582323584;250582328817;5233;0,1,2;3;9;1;3;1
250582328817;250582329600;783;0,1,2;3;9;1;3;1
250582329600;250582333649;4049;0,1,2;3;9;1;3;1
250582333649;250582333731;82;0,1,2;3;9;1;3;1
250582333731;250582333918;187;0,1,2;3;9;1;3;1
250582333918;250582334150;232;0,1,2;3;9;1;3;1
250582334150;250582340841;6691;0,1,2;3;9;1;3;1
250582340841;250582341088;247;0,1,2;3;9;1;3;1
250582341088;250582345417;4329;0,1,2;3;9;1;3;1
250582345417;250582347003;1586;0,1,2;3;9;1;3;1
250582347003;250582349378;2375;0,1,2;3;9;1;3;1
250582349378;250582349395;17;0,1,2;3;9;1;3;1
250582349395;250582349450;55;0,1,2;3;9;1;3;1
250582349450;250582350224;774;0,1,2;3;9;1;3;1
250582350224;250582350437;213;0,1,2;3;9;1;3;1
250582350437;250582350514;77;0,1,2;3;9;1;3;1
250582350514;250582352322;1808;0,1,2;3;9;1;3;1
250582352322;250582353320;998;0,1,2;3;9;1;3;1
250582353320;250582353394;74;0,1,2;3;9;1;3;1
250582353394;250582353857;463;0,1,2;3;9;1;3;1
250582353857;250582353998;141;0,1,2;3;9;1;3;1
250582353998;250582354053;55;0,1,2;3;9;1;3;1
250582354053;250582354408;355;0,1,2;3;9;1;3;1
250582354408;250582354555;147;0,1,2;3;9;1;3;1
250582354555;250582355901;1346;0,1,2;3;9;1;3;1
250582355901;250582356929;1028;0,1,2;3;9;1;3;1
250582356929;250582356995;66;0,1,2;3;9;1;3;1
250582356995;250582357084;89;0,1,2;3;9;1;3;1
250582357084;250582357650;566;0,1,2;3;9;1;3;1
250582357650;250582358450;800;0,1,2;3;9;1;3;1
250582358450;250582358778;328;0,1,2;3;9;1;3;1
250582358778;250582358816;38;0,1,2;3;9;1;3;1
250582358816;250582359124;308;0,1,2;3;9;1;3;1
250582359124;250582359691;567;0,1,2;3;9;1;3;1
250582359691;250582361816;2125;0,1,2;3;9;1;3;1
250582361816;250582362873;1057;0,1,2;3;9;1;3;1
250582362873;250582364367;1494;0,1,2;3;9;1;3;1
250582364367;250582372800;8433;0,1,2;3;9;1;3;1
250582372800;250582380241;7441;0,1,2;3;9;1;3;1
250582380241;250582381495;1254;0,1,2;3;9;1;3;1
250582381495;250582385268;3773;0,1,2;3;9;1;3;1
250582385268;250582385971;703;0,1,2;3;9;1;3;1
250582385971;250582386040;69;0,1,2;3;9;1;3;1
250582386040;250582386906;866;0,1,2;3;9;1;3;1
250582386906;250582389026;2120;0,1,2;3;9;1;3;1
250582389026;250582390301;1275;0,1,2;3;9;1;3;1
250582390301;250582390494;193;0,1,2;3;9;1;3;1
250582390494;250582390569;75;0,1,2;3;9;1;3;1
250582390569;250582391131;562;0,1,2;3;9;1;3;1
250582391131;250582391732;601;0,1,2;3;9;1;3;1
250582391732;250582393120;1388;0,1,2;3;9;1;3;1
250582393120;250582393923;803;0,1,2;3;9;1;3;1
250582393923;250582393985;62;0,1,2;3;9;1;3;1
250582393985;250582394013;28;0,1,2;3;9;1;3;1
250582394013;250582394062;49;0,1,2;3;9;1;3;1
250582394062;250582394116;54;0,1,2;3;9;1;3;1
250582394116;250582394292;176;0,1,2;3;9;1;3;1
250582394292;250582396117;1825;0,1,2;3;9;1;3;1
250582396117;250582398663;2546;0,1,2;3;9;1;3;1
250582398663;250582400768;2105;0,1,2;3;9;1;3;1
250582400768;250582400990;222;0,1,2;3;9;1;3;1
250582400990;250582402642;1652;0,1,2;3;9;1;3;1
250582402642;250582412144;9502;0,1,2;3;9;1;3;1
250582412144;250582412206;62;0,1,2;3;9;1;3;1
250582412206;250582413370;1164;0,1,2;3;9;1;3;1
250582413370;250582413719;349;0,1,2;3;9;1;3;1
250582413719;250582413784;65;0,1,2;3;9;1;3;1
250582413784;250582414218;434;0,1,2;3;9;1;3;1
250582414218;250582414428;210;0,1,2;3;9;1;3;1
250582414428;250582414885;457;0,1,2;3;9;1;3;1
250582414885;250582415762;877;0,1,2;3;9;1;3;1
250582415762;250582416637;875;0,1,2;3;9;1;3;1
250582416637;250582418804;2167;0,1,2;3;9;1;3;1
250582418804;250582418896;92;0,1,2;3;9;1;3;1
250582418896;250582425083;6187;0,1,2;3;9;1;3;1
250582425083;250582426215;1132;0,1,2;3;9;1;3;1
250582426215;250582428536;2321;0,1,2;3;9;1;3;1
250582428536;250582433022;4486;0,1,2;3;9;1;3;1
250582433022;250582436077;3055;0,1,2;3;9;1;3;1
250582436077;250582437353;1276;0,1,2;3;9;1;3;1
250582437353;250582437567;214;0,1,2;3;9;1;3;1
250582437567;250582438213;646;0,1,2;3;9;1;3;1
250582438213;250582439173;960;0,1,2;3;9;1;3;1
250582439173;250582439505;332;0,1,2;3;9;1;3;1
250582439505;250582439691;186;0,1,2;3;9;1;3;1
250582439691;250582439786;95;0,1,2;3;9;1;3;1
250582439786;250582441669;1883;0,1,2;3;9;1;3;1
250582441669;250582442812;1143;0,1,2;3;9;1;3;1
250582442812;250582446774;3962;0,1,2;3;9;1;3;1
250582446774;250582448429;1655;0,1,2;3;9;1;3;1
250582448429;250582449466;1037;0,1,2;3;9;1;3;1
250582449466;250582454096;4630;0,1,2;3;9;1;3;1
250582454096;250582454744;648;0,1,2;3;9;1;3;1
250582454744;250582456112;1368;0,1,2;3;9;1;3;1
250582456112;250582463572;7460;0,1,2;3;9;1;3;1
250582463572;250582479282;15710;0,1,2;3;9;1;3;1
250582479282;250582481849;2567;0,1,2;3;9;1;3;1
250582481849;250582497065;15216;0,1,2;3;9;1;3;1
250582497065;250582501757;4692;0,1,2;3;9;1;3;1
250582501757;250582502218;461;0,1,2;3;9;1;3;1
250582502218;250582502417;199;0,1,2;3;9;1;3;1
250582502417;250582503142;725;0,1,2;3;9;1;3;1
250582503142;250582505294;2152;0,1,2;3;9;1;3;1
250582505294;250582505883;589;0,1,2;3;9;1;3;1
250582505883;250582506442;559;0,1,2;3;9;1;3;1
250582506442;250582506971;529;0,1,2;3;9;1;3;1
250582506971;250582507269;298;0,1,2;3;9;1;3;1
250582507269;250582508046;777;0,1,2;3;9;1;3;1
250582508046;250582508161;115;0,1,2;3;9;1;3;1
250582508161;250582508374;213;0,1,2;3;9;1;3;1
250582508374;250582508590;216;0,1,2;3;9;1;3;1
250582508590;250582508724;134;0,1,2;3;9;1;3;1
250582508724;250582534496;25772;0,1,2;3;9;1;3;1
250582534496;250582534510;14;0,1,2;3;9;1;3;1
250582534510;250582534725;215;0,1,2;3;9;1;3;1
250582534725;250582535319;594;0,1,2;3;9;1;3;1
250582535319;250582537765;2446;0,1,2;3;9;1;3;1
250582537765;250582538221;456;0,1,2;3;9;1;3;1
250582538221;250582539539;1318;0,1,2;3;9;1;3;1
250582539539;250582546123;6584;0,1,2;3;9;1;3;1
250582546123;250582548901;2778;0,1,2;3;9;1;3;1
250582548901;250582549499;598;0,1,2;3;9;1;3;1
250582549499;250582549810;311;0,1,2;3;9;1;3;1
250582549810;250582550656;846;0,1,2;3;9;1;3;1
250582550656;250582552166;1510;0,1,2;3;9;1;3;1
250582552166;250582552983;817;0,1,2;3;9;1;3;1
250582552983;250582555934;2951;0,1,2;3;9;1;3;1
250582555934;250582559203;3269;0,1,2;3;9;1;3;1
250582559203;250582562069;2866;0,1,2;3;9;1;3;1
250582562069;250582564884;2815;0,1,2;3;9;1;3;1
250582564884;250582565552;668;0,1,2;3;9;1;3;1
250582565552;250582566681;1129;0,1,2;3;9;1;3;1
250582566681;250582567499;818;0,1,2;3;9;1;3;1
250582567499;250582568370;871;0,1,2;3;9;1;3;1
250582568370;250582568539;169;0,1,2;3;9;1;3;1
250582568539;250582571800;3261;0,1,2;3;9;1;3;1
250582571800;250582571874;74;0,1,2;3;9;1;3;1
250582571874;250582572841;967;0,1,2;3;9;1;3;1
250582572841;250582573032;191;0,1,2;3;9;1;3;1
250582573032;250582573070;38;0,1,2;3;9;1;3;1
250582573070;250582573867;797;0,1,2;3;9;1;3;1
250582573867;250582574197;330;0,1,2;3;9;1;3;1
250582574197;250582574652;455;0,1,2;3;9;1;3;1
250582574652;250582574728;76;0,1,2;3;9;1;3;1
250582574728;250582574935;207;0,1,2;3;9;1;3;1
250582574935;250582576054;1119;0,1,2;3;9;1;3;1
250582576054;250582576654;600;0,1,2;3;9;1;3;1
250582576654;250582576768;114;0,1,2;3;9;1;3;1
250582576768;250582577341;573;0,1,2;3;9;1;3;1
250582577341;250582580894;3553;0,1,2;3;9;1;3;1
250582580894;250582582429;1535;0,1,2;3;9;1;3;1
250582582429;250582582473;44;0,1,2;3;9;1;3;1
250582582473;250582582958;485;0,1,2;3;9;1;3;1
250582582958;250582582982;24;0,1,2;3;9;1;3;1
250582582982;250582583165;183;0,1,2;3;9;1;3;1
250582583165;250582583761;596;0,1,2;3;9;1;3;1
250582583761;250582587375;3614;0,1,2;3;9;1;3;1
250582587375;250582587657;282;0,1,2;3;9;1;3;1
250582587657;250582587727;70;0,1,2;3;9;1;3;1
250582587727;250582588569;842;0,1,2;3;9;1;3;1
250582588569;250582590603;2034;0,1,2;3;9;1;3;1
250582590603;250582591127;524;0,1,2;3;9;1;3;1
250582591127;250582593354;2227;0,1,2;3;9;1;3;1
250582593354;250582593716;362;0,1,2;3;9;1;3;1
250582593716;250582603901;10185;0,1,2;3;9;1;3;1
250582603901;250582610555;6654;0,1,2;3;9;1;3;1
250582610555;250582617038;6483;0,1,2;3;9;1;3;1
250582617038;250582619833;2795;0,1,2;3;9;1;3;1
250582619833;250582619876;43;0,1,2;3;9;1;3;1
250582619876;250582622934;3058;0,1,2;3;9;1;3;1
250582622934;250582623190;256;0,1,2;3;9;1;3;1
250582623190;250582623225;35;0,1,2;3;9;1;3;1
250582623225;250582623287;62;0,1,2;3;9;1;3;1
250582623287;250582623475;188;0,1,2;3;9;1;3;1
250582623475;250582623477;2;0,1,2;3;9;1;3;1
250582623477;250582623542;65;0,1,2;3;9;1;3;1
250582623542;250582623577;35;0,1,2;3;9;1;3;1
250582623577;250582623709;132;0,1,2;3;9;1;3;1
250582623709;250582623747;38;0,1,2;3;9;1;3;1
250582623747;250582624030;283;0,1,2;3;9;1;3;1
250582624030;250582624060;30;0,1,2;3;9;1;3;1
250582624060;250582630279;6219;0,1,2;3;9;1;3;1
250582630279;250582630840;561;0,1,2;3;9;1;3;1
250582630840;250582630925;85;0,1,2;3;9;1;3;1
250582630925;250582631139;214;0,1,2;3;9;1;3;1
250582631139;250582632221;1082;0,1,2;3;9;1;3;1
250582632221;250582632765;544;0,1,2;3;9;1;3;1
250582632765;250582633211;446;0,1,2;3;9;1;3;1
250582633211;250582634393;1182;0,1,2;3;9;1;3;1
250582634393;250582635753;1360;0,1,2;3;9;1;3;1
250582635753;250582636429;676;0,1,2;3;9;1;3;1
250582636429;250582637094;665;0,1,2;3;9;1;3;1
250582637094;250582637296;202;0,1,2;3;9;1;3;1
250582637296;250582638159;863;0,1,2;3;9;1;3;1
250582638159;250582638321;162;0,1,2;3;9;1;3;1
250582638321;250582638389;68;0,1,2;3;9;1;3;1
250582638389;250582640587;2198;0,1,2;3;9;1;3;1
250582640587;250582642980;2393;0,1,2;3;9;1;3;1
250582642980;250582643034;54;0,1,2;3;9;1;3;1
250582643034;250582644133;1099;0,1,2;3;9;1;3;1
250582644133;250582645237;1104;0,1,2;3;9;1;3;1
250582645237;250582645278;41;0,1,2;3;9;1;3;1
250582645278;250582646467;1189;0,1,2;3;9;1;3;1
250582646467;250582648114;1647;0,1,2;3;9;1;3;1
250582648114;250582648371;257;0,1,2;3;9;1;3;1
250582648371;250582652541;4170;0,1,2;3;9;1;3;1
250582652541;250582654430;1889;0,1,2;3;9;1;3;1
250582654430;250582654505;75;0,1,2;3;9;1;3;1
250582654505;250582654909;404;0,1,2;3;9;1;3;1
250582654909;250582655344;435;0,1,2;3;9;1;3;1
250582655344;250582655460;116;0,1,2;3;9;1;3;1
250582655460;250582655607;147;0,1,2;3;9;1;3;1
250582655607;250582663829;8222;0,1,2;3;9;1;3;1
250582663829;250582664411;582;0,1,2;3;9;1;3;1
250582664411;250582665932;1521;0,1,2;3;9;1;3;1
250582665932;250582666013;81;0,1,2;3;9;1;3;1
250582666013;250582667836;1823;0,1,2;3;9;1;3;1
250582667836;250582668358;522;0,1,2;3;9;1;3;1
250582668358;250582671457;3099;0,1,2;3;9;1;3;1
250582671457;250582671523;66;0,1,2;3;9;1;3;1
250582671523;250582671557;34;0,1,2;3;9;1;3;1
250582671557;250582672958;1401;0,1,2;3;9;1;3;1
250582672958;250582673901;943;0,1,2;3;9;1;3;1
250582673901;250582674173;272;0,1,2;3;9;1;3;1
250582674173;250582675324;1151;0,1,2;3;9;1;3;1
250582675324;250582675766;442;0,1,2;3;9;1;3;1
250582675766;250582680736;4970;0,1,2;3;9;1;3;1
250582680736;250582680843;107;0,1,2;3;9;1;3;1
250582680843;250582681206;363;0,1,2;3;9;1;3;1
250582681206;250582681460;254;0,1,2;3;9;1;3;1
250582681460;250582682987;1527;0,1,2;3;9;1;3;1
250582682987;250582683781;794;0,1,2;3;9;1;3;1
250582683781;250582684441;660;0,1,2;3;9;1;3;1
250582684441;250582684916;475;0,1,2;3;9;1;3;1
250582684916;250582686606;1690;0,1,2;3;9;1;3;1
250582686606;250582688459;1853;0,1,2;3;9;1;3;1
250582688459;250582688630;171;0,1,2;3;9;1;3;1
250582688630;250582689304;674;0,1,2;3;9;1;3;1
250582689304;250582689539;235;0,1,2;3;9;1;3;1
250582689539;250582690331;792;0,1,2;3;9;1;3;1
250582690331;250582690513;182;0,1,2;3;9;1;3;1
250582690513;250582692041;1528;0,1,2;3;9;1;3;1
250582692041;250582692825;784;0,1,2;3;9;1;3;1
250582692825;250582693497;672;0,1,2;3;9;1;3;1
250582693497;250582693710;213;0,1,2;3;9;1;3;1
250582693710;250582693760;50;0,1,2;3;9;1;3;1
250582693760;250582693802;42;0,1,2;3;9;1;3;1
250582693802;250582693974;172;0,1,2;3;9;1;3;1
250582693974;250582694006;32;0,1,2;3;9;1;3;1
250582694006;250582694154;148;0,1,2;3;9;1;3;1
250582694154;250582694250;96;0,1,2;3;9;1;3;1
250582694250;250582694382;132;0,1,2;3;9;1;3;1
250582694382;250582694538;156;0,1,2;3;9;1;3;1
250582694538;250582696639;2101;0,1,2;3;9;1;3;1
250582696639;250582697228;589;0,1,2;3;9;1;3;1
250582697228;250582698746;1518;0,1,2;3;9;1;3;1
250582698746;250582698806;60;0,1,2;3;9;1;3;1
250582698806;250582700303;1497;0,1,2;3;9;1;3;1
250582700303;250582700906;603;0,1,2;3;9;1;3;1
250582700906;250582702699;1793;0,1,2;3;9;1;3;1
250582702699;250582702986;287;0,1,2;3;9;1;3;1
250582702986;250582703396;410;0,1,2;3;9;1;3;1
250582703396;250582703619;223;0,1,2;3;9;1;3;1
250582703619;250582703658;39;0,1,2;3;9;1;3;1
250582703658;250582703764;106;0,1,2;3;9;1;3;1
250582703764;250582703814;50;0,1,2;3;9;1;3;1
250582703814;250582705407;1593;0,1,2;3;9;1;3;1
250582705407;250582707155;1748;0,1,2;3;9;1;3;1
250582707155;250582707262;107;0,1,2;3;9;1;3;1
250582707262;250582707508;246;0,1,2;3;9;1;3;1
250582707508;250582710187;2679;0,1,2;3;9;1;3;1
250582710187;250582710259;72;0,1,2;3;9;1;3;1
250582710259;250582711240;981;0,1,2;3;9;1;3;1
250582711240;250582711290;50;0,1,2;3;9;1;3;1
250582711290;250582711908;618;0,1,2;3;9;1;3;1
250582711908;250582711948;40;0,1,2;3;9;1;3;1
250582711948;250582712444;496;0,1,2;3;9;1;3;1
250582712444;250582713825;1381;0,1,2;3;9;1;3;1
250582713825;250582714198;373;0,1,2;3;9;1;3;1
250582714198;250582714241;43;0,1,2;3;9;1;3;1
250582714241;250582716662;2421;0,1,2;3;9;1;3;1
250582716662;250582716870;208;0,1,2;3;9;1;3;1
250582716870;250582716944;74;0,1,2;3;9;1;3;1
250582716944;250582716987;43;0,1,2;3;9;1;3;1
250582716987;250582717443;456;0,1,2;3;9;1;3;1
250582717443;250582718176;733;0,1,2;3;9;1;3;1
250582718176;250582719057;881;0,1,2;3;9;1;3;1
250582719057;250582721530;2473;0,1,2;3;9;1;3;1
250582721530;250582722822;1292;0,1,2;3;9;1;3;1
250582722822;250582722864;42;0,1,2;3;9;1;3;1
250582722864;250582724118;1254;0,1,2;3;9;1;3;1
250582724118;250582725859;1741;0,1,2;3;9;1;3;1
250582725859;250582726265;406;0,1,2;3;9;1;3;1
250582726265;250582726305;40;0,1,2;3;9;1;3;1
250582726305;250582726848;543;0,1,2;3;9;1;3;1
250582726848;250582727736;888;0,1,2;3;9;1;3;1
250582727736;250582731300;3564;0,1,2;3;9;1;3;1
250582731300;250582731323;23;0,1,2;3;9;1;3;1
250582731323;250582732147;824;0,1,2;3;9;1;3;1
250582732147;250582732572;425;0,1,2;3;9;1;3;1
250582732572;250582733008;436;0,1,2;3;9;1;3;1
250582733008;250582733049;41;0,1,2;3;9;1;3;1
250582733049;250582735019;1970;0,1,2;3;9;1;3;1
250582735019;250582735895;876;0,1,2;3;9;1;3;1
250582735895;250582736063;168;0,1,2;3;9;1;3;1
250582736063;250582739684;3621;0,1,2;3;9;1;3;1
250582739684;250582740756;1072;0,1,2;3;9;1;3;1
250582740756;250582742422;1666;0,1,2;3;9;1;3;1
250582742422;250582742511;89;0,1,2;3;9;1;3;1
250582742511;250582742694;183;0,1,2;3;9;1;3;1
250582742694;250582742818;124;0,1,2;3;9;1;3;1
250582742818;250582742891;73;0,1,2;3;9;1;3;1
250582742891;250582743065;174;0,1,2;3;9;1;3;1
250582743065;250582743424;359;0,1,2;3;9;1;3;1
250582743424;250582743513;89;0,1,2;3;9;1;3;1
250582743513;250582743576;63;0,1,2;3;9;1;3;1
250582743576;250582744107;531;0,1,2;3;9;1;3;1
250582744107;250582744139;32;0,1,2;3;9;1;3;1
250582744139;250582744302;163;0,1,2;3;9;1;3;1
250582744302;250582746389;2087;0,1,2;3;9;1;3;1
250582746389;250582747613;1224;0,1,2;3;9;1;3;1
250582747613;250582747661;48;0,1,2;3;9;1;3;1
250582747661;250582747864;203;0,1,2;3;9;1;3;1
250582747864;250582748169;305;0,1,2;3;9;1;3;1
250582748169;250582748484;315;0,1,2;3;9;1;3;1
250582748484;250582749468;984;0,1,2;3;9;1;3;1
250582749468;250582749517;49;0,1,2;3;9;1;3;1
250582749517;250582749616;99;0,1,2;3;9;1;3;1
250582749616;250582749669;53;0,1,2;3;9;1;3;1
250582749669;250582750028;359;0,1,2;3;9;1;3;1
250582750028;250582753041;3013;0,1,2;3;9;1;3;1
250582753041;250582753128;87;0,1,2;3;9;1;3;1
250582753128;250582753246;118;0,1,2;3;9;1;3;1
250582753246;250582753316;70;0,1,2;3;9;1;3;1
250582753316;250582753380;64;0,1,2;3;9;1;3;1
250582753380;250582753422;42;0,1,2;3;9;1;3;1
250582753422;250582753449;27;0,1,2;3;9;1;3;1
250582753449;250582753512;63;0,1,2;3;9;1;3;1
250582753512;250582753563;51;0,1,2;3;9;1;3;1
250582753563;250582753581;18;0,1,2;3;9;1;3;1
250582753581;250582753687;106;0,1,2;3;9;1;3;1
250582753687;250582753770;83;0,1,2;3;9;1;3;1
250582753770;250582753779;9;0,1,2;3;9;1;3;1
250582753779;250582754953;1174;0,1,2;3;9;1;3;1
250582754953;250582755505;552;0,1,2;3;9;1;3;1
250582755505;250582755569;64;0,1,2;3;9;1;3;1
250582755569;250582756101;532;0,1,2;3;9;1;3;1
250582756101;250582757238;1137;0,1,2;3;9;1;3;1
250582757238;250582757590;352;0,1,2;3;9;1;3;1
250582757590;250582757673;83;0,1,2;3;9;1;3;1
250582757673;250582757756;83;0,1,2;3;9;1;3;1
250582757756;250582757981;225;0,1,2;3;9;1;3;1
250582757981;250582758267;286;0,1,2;3;9;1;3;1
250582758267;250582759060;793;0,1,2;3;9;1;3;1
250582759060;250582760330;1270;0,1,2;3;9;1;3;1
250582760330;250582760494;164;0,1,2;3;9;1;3;1
250582760494;250582760627;133;0,1,2;3;9;1;3;1
250582760627;250582761956;1329;0,1,2;3;9;1;3;1
250582761956;250582762338;382;0,1,2;3;9;1;3;1
250582762338;250582763175;837;0,1,2;3;9;1;3;1
250582763175;250582768241;5066;0,1,2;3;9;1;3;1
250582768241;250582769884;1643;0,1,2;3;9;1;3;1
250582769884;250582772950;3066;0,1,2;3;9;1;3;1
250582772950;250582773702;752;0,1,2;3;9;1;3;1
250582773702;250582775725;2023;0,1,2;3;9;1;3;1
250582775725;250582778478;2753;0,1,2;3;9;1;3;1
250582778478;250582778595;117;0,1,2;3;9;1;3;1
250582778595;250582779060;465;0,1,2;3;9;1;3;1
250582779060;250582779109;49;0,1,2;3;9;1;3;1
250582779109;250582779130;21;0,1,2;3;9;1;3;1
250582779130;250582779266;136;0,1,2;3;9;1;3;1
250582779266;250582779432;166;0,1,2;3;9;1;3;1
250582779432;250582779506;74;0,1,2;3;9;1;3;1
250582779506;250582779535;29;0,1,2;3;9;1;3;1
250582779535;250582779595;60;0,1,2;3;9;1;3;1
250582779595;250582779799;204;0,1,2;3;9;1;3;1
250582779799;250582779801;2;0,1,2;3;9;1;3;1
250582779801;250582779856;55;0,1,2;3;9;1;3;1
250582779856;250582779877;21;0,1,2;3;9;1;3;1
250582779877;250582779921;44;0,1,2;3;9;1;3;1
250582779921;250582783334;3413;0,1,2;3;9;1;3;1
250582783334;250582783511;177;0,1,2;3;9;1;3;1
250582783511;250582783542;31;0,1,2;3;9;1;3;1
250582783542;250582784255;713;0,1,2;3;9;1;3;1
250582784255;250582787671;3416;0,1,2;3;9;1;3;1
250582787671;250582787695;24;0,1,2;3;9;1;3;1
250582787695;250582787720;25;0,1,2;3;9;1;3;1
250582787720;250582787728;8;0,1,2;3;9;1;3;1
250582787728;250582787750;22;0,1,2;3;9;1;3;1
250582787750;250582787798;48;0,1,2;3;9;1;3;1
250582787798;250582787834;36;0,1,2;3;9;1;3;1
250582787834;250582787989;155;0,1,2;3;9;1;3;1
250582787989;250582789780;1791;0,1,2;3;9;1;3;1
250582789780;250582790872;1092;0,1,2;3;9;1;3;1
250582790872;250582791808;936;0,1,2;3;9;1;3;1
250582791808;250582791945;137;0,1,2;3;9;1;3;1
250582791945;250582792275;330;0,1,2;3;9;1;3;1
250582792275;250582792513;238;0,1,2;3;9;1;3;1
250582792513;250582792842;329;0,1,2;3;9;1;3;1
250582792842;250582793044;202;0,1,2;3;9;1;3;1
250582793044;250582793223;179;0,1,2;3;9;1;3;1
250582793223;250582793244;21;0,1,2;3;9;1;3;1
250582793244;250582793400;156;0,1,2;3;9;1;3;1
250582793400;250582793428;28;0,1,2;3;9;1;3;1
250582793428;250582794115;687;0,1,2;3;9;1;3;1
250582794115;250582794408;293;0,1,2;3;9;1;3;1
250582794408;250582794468;60;0,1,2;3;9;1;3;1
250582794468;250582794482;14;0,1,2;3;9;1;3;1
250582794482;250582794498;16;0,1,2;3;9;1;3;1
250582794498;250582794601;103;0,1,2;3;9;1;3;1
250582794601;250582795176;575;0,1,2;3;9;1;3;1
250582795176;250582795402;226;0,1,2;3;9;1;3;1
250582795402;250582795422;20;0,1,2;3;9;1;3;1
250582795422;250582795518;96;0,1,2;3;9;1;3;1
250582795518;250582795646;128;0,1,2;3;9;1;3;1
250582795646;250582795706;60;0,1,2;3;9;1;3;1
250582795706;250582796234;528;0,1,2;3;9;1;3;1
250582796234;250582797528;1294;0,1,2;3;9;1;3;1
250582797528;250582798551;1023;0,1,2;3;9;1;3;1
250582798551;250582798819;268;0,1,2;3;9;1;3;1
250582798819;250582798829;10;0,1,2;3;9;1;3;1
250582798829;250582798915;86;0,1,2;3;9;1;3;1
250582798915;250582798935;20;0,1,2;3;9;1;3;1
250582798935;250582799042;107;0,1,2;3;9;1;3;1
250582799042;250582800793;1751;0,1,2;3;9;1;3;1
250582800793;250582801258;465;0,1,2;3;9;1;3;1
250582801258;250582801339;81;0,1,2;3;9;1;3;1
250582801339;250582802295;956;0,1,2;3;9;1;3;1
250582802295;250582802828;533;0,1,2;3;9;1;3;1
250582802828;250582802966;138;0,1,2;3;9;1;3;1
250582802966;250582803038;72;0,1,2;3;9;1;3;1
250582803038;250582803724;686;0,1,2;3;9;1;3;1
250582803724;250582805460;1736;0,1,2;3;9;1;3;1
250582805460;250582805505;45;0,1,2;3;9;1;3;1
250582805505;250582805885;380;0,1,2;3;9;1;3;1
250582805885;250582805894;9;0,1,2;3;9;1;3;1
250582805894;250582806048;154;0,1,2;3;9;1;3;1
250582806048;250582806530;482;0,1,2;3;9;1;3;1
250582806530;250582806560;30;0,1,2;3;9;1;3;1
250582806560;250582806605;45;0,1,2;3;9;1;3;1
250582806605;250582807545;940;0,1,2;3;9;1;3;1
250582807545;250582807643;98;0,1,2;3;9;1;3;1
250582807643;250582807963;320;0,1,2;3;9;1;3;1
250582807963;250582808479;516;0,1,2;3;9;1;3;1
250582808479;250582809052;573;0,1,2;3;9;1;3;1
250582809052;250582809277;225;0,1,2;3;9;1;3;1
250582809277;250582809643;366;0,1,2;3;9;1;3;1
250582809643;250582809891;248;0,1,2;3;9;1;3;1
250582809891;250582809917;26;0,1,2;3;9;1;3;1
250582809917;250582809966;49;0,1,2;3;9;1;3;1
250582809966;250582809978;12;0,1,2;3;9;1;3;1
250582809978;250582810250;272;0,1,2;3;9;1;3;1
250582810250;250582811160;910;0,1,2;3;9;1;3;1
250582811160;250582811638;478;0,1,2;3;9;1;3;1
250582811638;250582811830;192;0,1,2;3;9;1;3;1
250582811830;250582812438;608;0,1,2;3;9;1;3;1
250582812438;250582812748;310;0,1,2;3;9;1;3;1
250582812748;250582813104;356;0,1,2;3;9;1;3;1
250582813104;250582815820;2716;0,1,2;3;9;1;3;1
250582815820;250582817056;1236;0,1,2;3;9;1;3;1
250582817056;250582817260;204;0,1,2;3;9;1;3;1
250582817260;250582818602;1342;0,1,2;3;9;1;3;1
250582818602;250582818658;56;0,1,2;3;9;1;3;1
250582818658;250582818713;55;0,1,2;3;9;1;3;1
250582818713;250582819165;452;0,1,2;3;9;1;3;1
250582819165;250582819202;37;0,1,2;3;9;1;3;1
250582819202;250582819598;396;0,1,2;3;9;1;3;1
250582819598;250582819638;40;0,1,2;3;9;1;3;1
250582819638;250582819831;193;0,1,2;3;9;1;3;1
250582819831;250582819904;73;0,1,2;3;9;1;3;1
250582819904;250582820032;128;0,1,2;3;9;1;3;1
250582820032;250582820132;100;0,1,2;3;9;1;3;1
250582820132;250582820160;28;0,1,2;3;9;1;3;1
250582820160;250582820197;37;0,1,2;3;9;1;3;1
250582820197;250582820288;91;0,1,2;3;9;1;3;1
250582820288;250582820449;161;0,1,2;3;9;1;3;1
250582820449;250582820997;548;0,1,2;3;9;1;3;1
250582820997;250582821059;62;0,1,2;3;9;1;3;1
250582821059;250582822533;1474;0,1,2;3;9;1;3;1
250582822533;250582822614;81;0,1,2;3;9;1;3;1
250582822614;250582823845;1231;0,1,2;3;9;1;3;1
250582823845;250582824073;228;0,1,2;3;9;1;3;1
250582824073;250582825041;968;0,1,2;3;9;1;3;1
250582825041;250582825391;350;0,1,2;3;9;1;3;1
250582825391;250582825636;245;0,1,2;3;9;1;3;1
250582825636;250582825936;300;0,1,2;3;9;1;3;1
250582825936;250582826157;221;0,1,2;3;9;1;3;1
250582826157;250582826498;341;0,1,2;3;9;1;3;1
250582826498;250582827104;606;0,1,2;3;9;1;3;1
250582827104;250582831153;4049;0,1,2;3;9;1;3;1
250582831153;250582831856;703;0,1,2;3;9;1;3;1
250582831856;250582832704;848;0,1,2;3;9;1;3;1
250582832704;250582833099;395;0,1,2;3;9;1;3;1
250582833099;250582833770;671;0,1,2;3;9;1;3;1
250582833770;250582834196;426;0,1,2;3;9;1;3;1
250582834196;250582834269;73;0,1,2;3;9;1;3;1
250582834269;250582835677;1408;0,1,2;3;9;1;3;1
250582835677;250582837906;2229;0,1,2;3;9;1;3;1
250582837906;250582838071;165;0,1,2;3;9;1;3;1
250582838071;250582838113;42;0,1,2;3;9;1;3;1
250582838113;250582839224;1111;0,1,2;3;9;1;3;1
250582839224;250582839302;78;0,1,2;3;9;1;3;1
250582839302;250582839366;64;0,1,2;3;9;1;3;1
250582839366;250582839662;296;0,1,2;3;9;1;3;1
250582839662;250582841947;2285;0,1,2;3;9;1;3;1
250582841947;250582842549;602;0,1,2;3;9;1;3;1
250582842549;250582842926;377;0,1,2;3;9;1;3;1
250582842926;250582843030;104;0,1,2;3;9;1;3;1
250582843030;250582843190;160;0,1,2;3;9;1;3;1
250582843190;250582843220;30;0,1,2;3;9;1;3;1
250582843220;250582843292;72;0,1,2;3;9;1;3;1
250582843292;250582843321;29;0,1,2;3;9;1;3;1
250582843321;250582843427;106;0,1,2;3;9;1;3;1
250582843427;250582843609;182;0,1,2;3;9;1;3;1
250582843609;250582844241;632;0,1,2;3;9;1;3;1
250582844241;250582845239;998;0,1,2;3;9;1;3;1
250582845239;250582845344;105;0,1,2;3;9;1;3;1
250582845344;250582845428;84;0,1,2;3;9;1;3;1
250582845428;250582845468;40;0,1,2;3;9;1;3;1
250582845468;250582845553;85;0,1,2;3;9;1;3;1
250582845553;250582845913;360;0,1,2;3;9;1;3;1
250582845913;250582846279;366;0,1,2;3;9;1;3;1
250582846279;250582846317;38;0,1,2;3;9;1;3;1
250582846317;250582846440;123;0,1,2;3;9;1;3;1
250582846440;250582846538;98;0,1,2;3;9;1;3;1
250582846538;250582847246;708;0,1,2;3;9;1;3;1
250582847246;250582848335;1089;0,1,2;3;9;1;3;1
250582848335;250582848385;50;0,1,2;3;9;1;3;1
250582848385;250582848602;217;0,1,2;3;9;1;3;1
250582848602;250582850379;1777;0,1,2;3;9;1;3;1
250582850379;250582850434;55;0,1,2;3;9;1;3;1
250582850434;250582850508;74;0,1,2;3;9;1;3;1
250582850508;250582850575;67;0,1,2;3;9;1;3;1
250582850575;250582850805;230;0,1,2;3;9;1;3;1
250582850805;250582850847;42;0,1,2;3;9;1;3;1
250582850847;250582850911;64;0,1,2;3;9;1;3;1
250582850911;250582851060;149;0,1,2;3;9;1;3;1
250582851060;250582851104;44;0,1,2;3;9;1;3;1
250582851104;250582851838;734;0,1,2;3;9;1;3;1
250582851838;250582853186;1348;0,1,2;3;9;1;3;1
250582853186;250582853237;51;0,1,2;3;9;1;3;1
250582853237;250582853857;620;0,1,2;3;9;1;3;1
250582853857;250582855001;1144;0,1,2;3;9;1;3;1
250582855001;250582855381;380;0,1,2;3;9;1;3;1
250582855381;250582855492;111;0,1,2;3;9;1;3;1
250582855492;250582855824;332;0,1,2;3;9;1;3;1
250582855824;250582856538;714;0,1,2;3;9;1;3;1
250582856538;250582856670;132;0,1,2;3;9;1;3;1
250582856670;250582857722;1052;0,1,2;3;9;1;3;1
250582857722;250582858626;904;0,1,2;3;9;1;3;1
250582858626;250582858748;122;0,1,2;3;9;1;3;1
250582858748;250582858927;179;0,1,2;3;9;1;3;1
250582858927;250582859384;457;0,1,2;3;9;1;3;1
250582859384;250582859425;41;0,1,2;3;9;1;3;1
250582859425;250582859648;223;0,1,2;3;9;1;3;1
250582859648;250582859862;214;0,1,2;3;9;1;3;1
250582859862;250582860889;1027;0,1,2;3;9;1;3;1
250582860889;250582862066;1177;0,1,2;3;9;1;3;1
250582862066;250582862105;39;0,1,2;3;9;1;3;1
250582862105;250582862544;439;0,1,2;3;9;1;3;1
250582862544;250582863975;1431;0,1,2;3;9;1;3;1
250582863975;250582865933;1958;0,1,2;3;9;1;3;1
250582865933;250582866544;611;0,1,2;3;9;1;3;1
250582866544;250582868193;1649;0,1,2;3;9;1;3;1
250582868193;250582869293;1100;0,1,2;3;9;1;3;1
250582869293;250582871289;1996;0,1,2;3;9;1;3;1
250582871289;250582871981;692;0,1,2;3;9;1;3;1
250582871981;250582875683;3702;0,1,2;3;9;1;3;1
250582875683;250582875781;98;0,1,2;3;9;1;3;1
250582875781;250582876065;284;0,1,2;3;9;1;3;1
250582876065;250582881315;5250;0,1,2;3;9;1;3;1
250582881315;250582883118;1803;0,1,2;3;9;1;3;1
250582883118;250582885916;2798;0,1,2;3;9;1;3;1
250582885916;250582886742;826;0,1,2;3;9;1;3;1
250582886742;250582887494;752;0,1,2;3;9;1;3;1
250582887494;250582887539;45;0,1,2;3;9;1;3;1
250582887539;250582887776;237;0,1,2;3;9;1;3;1
250582887776;250582888522;746;0,1,2;3;9;1;3;1
250582888522;250582888605;83;0,1,2;3;9;1;3;1
250582888605;250582893399;4794;0,1,2;3;9;1;3;1
250582893399;250582894032;633;0,1,2;3;9;1;3;1
250582894032;250582896055;2023;0,1,2;3;9;1;3;1
250582896055;250582896689;634;0,1,2;3;9;1;3;1
250582896689;250582897168;479;0,1,2;3;9;1;3;1
250582897168;250582897236;68;0,1,2;3;9;1;3;1
250582897236;250582897859;623;0,1,2;3;9;1;3;1
250582897859;250582898735;876;0,1,2;3;9;1;3;1
250582898735;250582899340;605;0,1,2;3;9;1;3;1
250582899340;250582899585;245;0,1,2;3;9;1;3;1
250582899585;250582899941;356;0,1,2;3;9;1;3;1
250582899941;250582900301;360;0,1,2;3;9;1;3;1
250582900301;250582900589;288;0,1,2;3;9;1;3;1
250582900589;250582900986;397;0,1,2;3;9;1;3;1
250582900986;250582901763;777;0,1,2;3;9;1;3;1
250582901763;250582902106;343;0,1,2;3;9;1;3;1
250582902106;250582903521;1415;0,1,2;3;9;1;3;1
250582903521;250582904411;890;0,1,2;3;9;1;3;1
250582904411;250582904447;36;0,1,2;3;9;1;3;1
250582904447;250582904832;385;0,1,2;3;9;1;3;1
719484426732;719662582959;178156227;-1;0;-1;0;-1;0
719662582959;719673711988;11129029;1;1;658;1;9;1
719673711988;719683973434;10261446;0,1;2;658,663;2;9;1
719683973434;719709771190;25797756;1;1;658;1;9;1
719709771190;721389288766;1679517576;-1;0;-1;0;-1;0
721389288766;721409357727;20068961;0;1;660;1;9;1
721409357727;722231259041;821901314;-1;0;-1;0;-1;0
722231259041;722289545223;58286182;1;1;673;1;9;1
722289545223;723151490432;861945209;-1;0;-1;0;-1;0
723151490432;723171519760;20029328;0;1;660;1;9;1
723171519760;724918498313;1746978553;-1;0;-1;0;-1;0
724918498313;724938494528;19996215;0;1;660;1;9;1
724938494528;801145097720;76206603192;-1;0;-1;0;-1;0
801145097720;801164480368;19382648;2;1;679;1;10;1
801164480368;801164567402;87034;1,2;2;679;1;10;1
801164567402;801164567863;461;1,2;2;679;1;10;1
801164567863;801164569595;1732;1,2;2;679;1;10;1
801164569595;801164570036;441;1,2;2;679;1;10;1
801164570036;801164570221;185;1,2;2;679;1;10;1
801164570221;801164570366;145;1,2;2;679;1;10;1
801164570366;801164570485;119;1,2;2;679;1;10;1
801164570485;801164570522;37;1,2;2;679;1;10;1
801164570522;801164570644;122;1,2;2;679;1;10;1
801164570644;801164570697;53;1,2;2;679;1;10;1
801164570697;801164570822;125;1,2;2;679;1;10;1
801164570822;801164570851;29;1,2;2;679;1;10;1
801164570851;801164570886;35;1,2;2;679;1;10;1
801164570886;801164570955;69;1,2;2;679;1;10;1
801164570955;801164571084;129;1,2;2;679;1;10;1
801164571084;801164571210;126;1,2;2;679;1;10;1
801164571210;801164571310;100;1,2;2;679;1;10;1
801164571310;801164571334;24;1,2;2;679;1;10;1